NO textures/wall_1.xpm
SO textures/wall_2.xpm
WE textures/wall_3.xpm
EA textures/wall_4.xpm

F 184,113,39
C 196,164,132

1111111111111111
100000000N000001
1000000000000001
1000000000000001
1111111111111111
