NO textures/wall_1.xpm
SO textures/wall_2.xpm
WE textures/wall_3.xpm
EA textures/wall_4.xpm

F 184,113,39
C 51,198,227

11111111111
1111000N111
11110100111
11101111111
11111111111