NO textures/wall_1.xpm
SO textures/wall_2.xpm
WE textures/wall_3.xpm
EA textures/wall_4.xpm

F 59,5,5
C 196,164,0

        1111111111111111111111111
        1000000000110000000000001
        1011000001110000000000001
        1001000000000000000000001
111111111011000001110000000000001
100000000011000001110000011111111
11110111111111011100000010001
11110111100010001101010010001
11000000000100000000000010001
10000000000000001100000000001
100000000000E0001101010000001
11000001110101011111011110001
11110111 1110101 101111010001
11111111 1111111 111111111111